00000101010101010000000100000101010100010000000000
01111101010101010111011101111101010101111101110111
00010000000000010100010000010000010000000001010100
01110111111111111111011111010101011111010101010101
00000001000000010101000000010101000100010100010000
11010111110101010101110111011111011111011111011111
00010100000101000001010101010001000001010000000000
11110111011111111111010101110101111101111101110101
01000100010000010000010000010100000001010001000100
01110101111101110101111101010101111101010111110111
00000100000001010100010001000101010000000001000000
01110101010101011111011101011101010111110111110111
01000001010100000101010001010100010001000001000000
11010111111111011101010111010111111101111111011111
01010101010000010000010001010000000100000001000100
01010101011111110111110111111101011111011101110101
00010100000100010101000001000001000001000101000000
01110111110111010101011101111101111111011111011111
01010100000001000100010001000001000001000100000000
11010101011111110101010111111101010101011111010111
00010001000100010101010101000100010101010001010100
11011111010101010111110101110101110101111101111101
00000000010101000001000000010000010100010000010000
11110111011101110111011111010111111111010111011101
01010001010100010000010000000001000100010100000000
01010111110101110111111101110101011101011111011101
00000101000100010101000001010100010001000100010000
11010101110111011101111101010101110111010111110111
00010000010100010001000000010101010101010001000000
11011111110111011101111111011111011101011101010101
00010100010000000001010000010100000000010001010100
11010111011111111101011111010101010111110101011111
01010100000101000001010001000101010100010100000000
01010101110101111101011101011111011111010111010101
00000000010001010001000001000001000100000001010100
01111101111101011101011111111101110111111111011111
01000000000101000100010000000100010001010100010000
11110111011101011101110111010111011101010101010111
00010101010100010100000001010100010100000101010100
01010101010111010111110101011101110111011101010101
01000100000101010001000101010000000100010001010100
11111101011101110111111101111111011111110111010101
00010001010101000001010000010001000001010101000000
01011111010101110101011111110101010111010101111111
01000000000000000100010000010100010000010001000000
01011111011111111101011101110111011101011101011111
01010100000000010001000001000100000101010100000100
11110101111111010101010101010111111101010111110101
00000000010000010101010100010100000001000001000000
01010101010101010101010101010101010101010101010101
